###########
#S#       #
# ### #####
#   #     #
# ### ### #
# #   #   #
# # ##### #
# #   # # #
# ### # # #
#       #G#
###########
