###########
#S        #
######### #
#         #
# #########
#         #
######### #
#         #
# #########
#        G#
###########
