###########
#S#       #
# # ##### #
# #     # #
# ### # # #
#     #   #
######### #
#         #
# ### #####
#        G#
###########
