###########
#    S    #
#         #
#         #
#         #
# #########
#         #
#         #
#         #
#    G    #
###########
