###############
#S#   #   #   #
# # ### # # # #
# #     # # # #
# ##### #   # #
#     # # ### #
# ### # # # # #
# #   # #   # #
# # ### ##### #
# # #     #   #
# # ##### # ###
# #       #   #
# ####### ### #
#   #       #G#
###############
