###############
#S#           #
# # ######### #
# #         # #
# ######### # #
#           # #
########### # #
#         #   #
# ##### # ### #
# #     #     #
# # ######### #
# #           #
# ### #########
#            G#
###############