###############
#S            #
############# #
#             #
# #############
#             #
############# #
#             #
# #############
#             #
############# #
#             #
# #############
#            G#
###############
