###############
#      S      #
#             #
#             #
#             #
#             #
# #############
#             #
#             #
#             #
#             #
#             #
#             #
#      G      #
###############
