###############
#S            #
#             #
#             #
#             #
#    #####    #
#    #####    #
#    #####    #
#    #####    #
#    #####    #
#             #
#             #
#             #
#            G#
###############
