#####
#S#G#
# # #
#   #
#####
