#####
#S  #
#   #
#  G#
#####
