#######
#S    #
#     #
#  #  #
#     #
#    G#
#######
