#######
#S#   #
# # # #
# #G# #
# ### #
#     #
#######
