#######
#  S  #
#     #
# #####
#     #
#  G  #
#######
