#######
#S    #
##### #
#     #
# #####
#    G#
#######
