#######
#S#   #
# # ###
# #   #
# # # #
#   #G#
#######
