#######
#S#   #
# # # #
#     #
# # # #
#   #G#
#######
