#######
#S#   #
# # # #
#   # #
# ### #
#    G#
#######
